**********
*        *
* * ******
* *      *
* ** * ***
* *  * ***
* *      *
* * ******
*        *
**********
